R 1800 1800
NO ./textures/kitten.xpm
SO ./textures/rainbow.xpm
WE ./textures/pinky.xpm
EA ./textures/lollies.xpm
S ./textures/sprite.xpm
F 255,152,213
C 125,206,250

 11111111111111111111111
 10000000000010101010101
110000000000000000000001
1000000001100002011001111111
1111112211111000011001100001111
  111000000001102000001111111
111100000000110000000021
100002000000000111000011
10100000000000000000001
1000000020001100000001111111111
1000011000000000200000000000001
10010000200E0002201100000000001
1001000000000022011001000000001
1111111111111111111111111111111
1121
1111
1
