R -12asldhashduaishdjn, , , , ,. .#a
NO ./textures/pinky.xpm
SO ./textures/rainbow.xpm
WE ./textures/rainbow.xpm
EA ./textures/lollies.xpm
S ./textures/sprite.xpm
F 200,213,250
C 135,86,80

 11111111111111111111111
 1000S000000010101010101
110000000000000000000001
100000000110000201100111
1111112211111000011001100001111
  111000000001102000001111111
111100000000110000000021
10000200000000011100001
10100000000000000000001
1000000020001100000001111111111
1000011000000000200000000000001
1001000020000002201100000000001
1001000000000022011001000000001
1111111111111111111111111111111
1121
1111
1
